1111111111111
101100C0000C1
1C10001111001
10001000P00E1
1111111111111