111111111111
1P0000000C01
1000010E0001
111111111111