11111
1C1E1
1C101
1PCC1
1CCC1
11111